Final translated message:
CON DURRUTI MORIA EL DIRIGENTE QUE, A SU MANERA, MEJOR EHPRESABA COMO COMBATIR AL FASCISMO DESDE UN CRITERIO DE INDEPENDENCIA
DE CLASE, A DIFERENCIA DEL COLABORACIONISMO FRENTEPOPULISTA DE LA DIRECCION ANARQUISTA.
DURRUTI FUE UN FACTOR DE PRIMER ORDEN EN EL PAPEL DE LA CLASE OBRERA EN CATALUNVA EN JULIO DE 1936. PERO DURRUTI, COMO OCURRE CON
LAS PERSONALIDADES EN LA YISTORIA, NO CAVO DEL CIELO. PERSONIFICABA LA TRADICION REVOLUCIONARIA DE LA CLASE OBRERA. SU ENORME
POPULARIDAD ENTRE LA CLASE TRABAJADORA, REFLEJADA EN EL ENTIERRO MULTITUDINARIO EN BARCELONA EL 22 DE NOVIEMBRE DE 1936,
MUESTRA ESA IDENTIFICACION. SU MUERTE FUE SIN DUDA UN GOLPE OBJETIVO AL PROCESO REVOLUCIONARIO EN MARCYA. SIN DURRUTI QUEDO MAS
LIBRE EL CAMINO PARA QUE EL ESTALINISMO, CON LA COMPLICIDAD DEL GOBIERNO DEL FRENTE POPULAR V DE LA DIRECCION ANARQUISTA,
TERMINARA EN MAVO DE 1937 LA TAREA DE LIQUIDAR LA REVOLUCION, DESMORALIÑANDO A LA CLASE OBRERA V FACILITANDO CON ELLO EL POSTERIOR
TRIUNFO FRANQUISTA.


Letter mappings (original -> swapped):
x -> E
e -> A
k -> R
i -> O
c -> I
j -> N
t -> L
a -> D
r -> C
z -> U
h -> T
n -> S
p -> M
d -> P
q -> B
o -> F
v -> V
s -> Q
g -> J
u -> G
m -> Y
f -> H
l -> Ñ
